###################
#S....#....##.....#
#.#.#.#.#####.#.#.#
#.#.#...#...#.#.#.#
#.#.#.###.#.#...#.#
#.........#...#..E#
###################