###################
#S....#....##...#E#
#.#.#.#.#####.#.###
#.#.#...#...#.#.#.#
#.#.#.###.#.#...#.#
#.........#...#...#
###################